4,1,2,1
1;,1;,1;,1;,1;,1;,1;,1;,1;,1;,1;,1;,1;,1;,1;,1;,1;,1;,1;,1;,1;,1;,1;,1;,1;,1;,1;,1;,1;,1;,1;,1;,1;,1;,1;,1;,1;,1;,1;,1;,1;,1;,1;,1;,1;,
1;,0;,0;,0;,0;,0;,0;,0;,0;,0;,0;,0;,0;,0;,0;,0;,0;,0;,0;,0;,0;,0;,0;,0;,0;,0;,0;,0;,0;,0;,0;,0;,0;,0;,0;,0;,0;,0;,0;,0;,0;,0;,0;,0;,1;,
1;,0;,0;,0;,0;,0;,0;,0;,0;,0;,0;,0;,0;,0;,0;,0;,0;,0;,0;,0;,0;,0;,0;,0;,0;,0;,0;,0;,0;,0;,0;,0;,0;,0;,0;,0;,0;,0;,0;,0;,0;,0;,0;,0;,1;,
1;,0;,0;,1;,1;,1;,1;,1;,1;,4;,4;,1;,1;,1;,4;,4;,1;,1;,1;,4;,4;,1;,1;,1;,4;,4;,1;,1;,1;,4;,4;,1;,1;,1;,4;,4;,1;,1;,1;,4;,4;,1;,1;,1;,1;,
1;,0;,0;,1;,0;,0;,0;,0;,0;,0;,0;,0;,0;,0;,0;,0;,0;,0;,0;,0;,0;,0;,0;,0;,0;,0;,0;,0;,0;,0;,0;,0;,0;,0;,0;,0;,0;,0;,0;,0;,0;,0;,0;,0;,1;,
1;,0;,0;,1;,0;,0;,0;,2;0,0;,0;,0;,0;,2;0,0;,0;,0;,0;,2;0,0;,0;,0;,0;,2;0,0;,0;,0;,0;,2;0,0;,0;,0;,0;,2;0,0;,0;,0;,0;,2;0,0;,0;,0;,0;,2;0,0;,1;,
1;,0;,0;,1;,0;,0;,2;3,1;,2;1,0;,0;,2;3,1;,2;1,6;,0;,2;3,1;,2;1,6;,6;,2;3,1;,2;1,6;,6;,2;3,1;,2;1,6;,6;,2;3,1;,2;1,6;,6;,2;3,1;,2;1,6;,6;,2;3,1;,2;1,1;,
1;,0;,0;,1;,0;,0;,0;,2;2,0;,0;,0;,0;,2;2,0;,0;,0;,0;,2;2,0;,0;,0;,0;,2;2,0;,0;,0;,0;,2;2,0;,0;,0;,0;,2;2,0;,0;,0;,0;,2;2,0;,0;,0;,0;,2;2,0;,1;,
1;,0;,0;,1;,0;,0;,0;,0;,0;,0;,0;,0;,0;,0;,0;,0;,0;,0;,0;,0;,0;,0;,0;,0;,0;,0;,0;,0;,0;,0;,0;,0;,0;,0;,0;,0;,0;,0;,0;,0;,0;,0;,0;,0;,1;,
1;,0;,0;,1;,0;,0;,0;,0;,0;,0;,0;,0;,0;,0;,0;,0;,0;,0;,0;,0;,0;,0;,0;,0;,0;,0;,0;,0;,0;,0;,0;,0;,0;,0;,0;,0;,0;,0;,0;,0;,0;,0;,0;,0;,1;,
1;,0;,0;,1;,0;,0;,0;,0;,0;,0;,0;,0;,0;,0;,0;,0;,0;,0;,0;,0;,0;,0;,0;,0;,0;,0;,0;,0;,0;,0;,0;,0;,0;,0;,0;,0;,0;,0;,0;,0;,0;,0;,0;,0;,1;,
1;,0;,0;,1;,4;,4;,1;,0;,1;,4;,4;,1;,0;,1;,4;,4;,1;,0;,1;,4;,4;,1;,0;,1;,4;,4;,1;,0;,1;,4;,4;,1;,0;,1;,4;,4;,1;,0;,1;,4;,4;,1;,0;,1;,1;,
1;,0;,0;,1;,4;,4;,4;,1;,4;,4;,4;,4;,1;,4;,4;,4;,4;,1;,4;,4;,4;,4;,1;,4;,6;,4;,4;,1;,4;,6;,6;,4;,1;,4;,6;,6;,4;,1;,4;,6;,6;,4;,1;,4;,1;,
1;,0;,0;,1;,4;,4;,4;,4;,4;,4;,4;,4;,4;,4;,4;,4;,4;,4;,4;,4;,4;,4;,4;,4;,4;,4;,4;,4;,4;,4;,4;,4;,4;,4;,4;,4;,4;,4;,4;,4;,4;,4;,4;,4;,1;,
1;,0;,0;,1;,4;,4;,4;,4;,4;,4;,4;,4;,4;,4;,4;,4;,4;,4;,4;,4;,4;,4;,4;,4;,4;,4;,4;,4;,4;,4;,4;,4;,4;,4;,6;,4;,4;,4;,4;,6;,6;,4;,4;,4;,1;,
1;,0;,0;,1;,1;,1;,0;,0;,0;,1;,1;,0;,0;,0;,1;,1;,0;,0;,0;,1;,1;,0;,0;,0;,1;,1;,0;,0;,0;,1;,1;,0;,0;,0;,1;,1;,0;,0;,0;,1;,1;,0;,0;,0;,1;,
1;,0;,0;,1;,0;,0;,0;,0;,0;,0;,0;,0;,0;,0;,0;,0;,0;,0;,0;,0;,0;,0;,0;,0;,0;,0;,0;,0;,0;,0;,0;,0;,0;,0;,0;,0;,0;,0;,0;,0;,0;,0;,0;,0;,1;,
1;,0;,0;,1;,0;,0;,0;,0;,0;,0;,0;,0;,0;,0;,0;,0;,0;,0;,0;,0;,0;,0;,0;,0;,0;,0;,0;,0;,0;,0;,0;,0;,0;,0;,0;,0;,0;,0;,0;,0;,0;,0;,0;,0;,1;,
1;,0;,0;,1;,0;,0;,0;,0;,0;,0;,0;,0;,0;,0;,0;,0;,0;,0;,0;,0;,0;,0;,0;,0;,0;,0;,0;,0;,0;,0;,0;,0;,0;,0;,0;,0;,0;,0;,0;,0;,0;,0;,0;,0;,1;,
1;,0;,0;,1;,0;,0;,0;,0;,0;,0;,0;,0;,0;,0;,0;,0;,0;,0;,0;,0;,0;,0;,0;,0;,0;,0;,0;,0;,0;,0;,0;,0;,0;,0;,0;,0;,0;,0;,0;,0;,0;,0;,0;,0;,1;,
1;,0;,0;,1;,0;,0;,1;,2;0,1;,1;,1;,1;,2;0,1;,1;,1;,1;,2;0,1;,1;,1;,1;,2;0,1;,1;,1;,1;,2;0,1;,1;,1;,1;,2;0,1;,1;,1;,1;,2;0,1;,1;,1;,1;,2;0,1;,1;,
1;,0;,0;,1;,0;,0;,1;,1;,1;,1;,1;,1;,1;,1;,1;,1;,1;,1;,1;,1;,1;,1;,1;,1;,1;,1;,1;,1;,1;,1;,1;,1;,1;,1;,1;,1;,1;,1;,1;,1;,1;,1;,1;,1;,1;,
0;,0;,0;,1;,0;,0;,0;,0;,0;,0;,0;,0;,0;,0;,0;,0;,0;,0;,0;,0;,0;,0;,0;,0;,0;,0;,0;,0;,0;,0;,0;,0;,0;,0;,0;,0;,0;,0;,0;,0;,0;,0;,0;,0;,1;,
8;,0;,0;,1;,0;,0;,0;,0;,0;,0;,0;,0;,0;,0;,0;,0;,0;,0;,0;,0;,0;,0;,0;,0;,0;,0;,0;,0;,0;,0;,0;,0;,0;,0;,0;,0;,0;,0;,0;,0;,0;,0;,0;,7;,1;,
1;,1;,1;,1;,1;,1;,1;,1;,1;,1;,1;,1;,1;,1;,1;,1;,1;,1;,1;,1;,1;,1;,1;,1;,1;,1;,1;,1;,1;,1;,1;,1;,1;,1;,1;,1;,1;,1;,1;,1;,1;,1;,1;,1;,1;,
