10,1,8,1
5;,5;,5;,5;,5;,5;,5;,5;,5;,5;,5;,5;,5;,5;,5;,5;,5;,5;,5;,5;,5;,5;,5;,5;,5;,5;,5;,5;,5;,5;,5;,5;,5;,5;,5;,5;,5;,5;,5;,5;,5;,5;,5;,5;,5;,
0;,0;,0;,0;,0;,0;,0;,0;,0;,0;,0;,0;,0;,0;,0;,0;,0;,0;,0;,0;,0;,0;,0;,0;,0;,0;,0;,0;,0;,0;,0;,0;,0;,0;,0;,0;,0;,0;,0;,0;,0;,0;,0;,0;,0;,
1;,1;,1;,1;,1;,1;,1;,1;,1;,1;,1;,1;,1;,1;,1;,0;,0;,0;,4;,4;,4;,4;,0;,0;,0;,0;,0;,0;,0;,0;,0;,0;,0;,0;,0;,0;,4;,4;,4;,4;,0;,0;,0;,0;,0;,
0;,0;,0;,0;,0;,0;,0;,0;,0;,0;,0;,0;,0;,0;,0;,0;,0;,0;,0;,0;,0;,0;,0;,0;,0;,0;,0;,0;,0;,0;,0;,0;,0;,0;,0;,0;,0;,0;,0;,0;,0;,0;,0;,0;,0;,
0;,0;,0;,0;,0;,0;,0;,0;,0;,0;,0;,0;,0;,0;,0;,0;,0;,0;,0;,0;,0;,0;,0;,0;,0;,0;,0;,0;,0;,0;,0;,0;,0;,0;,0;,0;,0;,0;,0;,0;,0;,0;,0;,0;,0;,
0;,0;,0;,0;,0;,0;,0;,0;,0;,0;,0;,0;,0;,0;,0;,0;,0;,0;,0;,0;,0;,0;,0;,0;,0;,0;,0;,0;,0;,0;,0;,0;,0;,0;,0;,0;,0;,0;,0;,0;,0;,0;,0;,0;,0;,
0;,0;,0;,0;,0;,0;,0;,0;,0;,0;,0;,0;,0;,0;,0;,0;,0;,0;,0;,0;,0;,0;,0;,0;,0;,0;,0;,0;,0;,0;,0;,0;,0;,0;,0;,0;,0;,0;,0;,0;,0;,0;,0;,0;,0;,
0;,0;,0;,0;,0;,0;,0;,0;,0;,0;,0;,0;,0;,0;,0;,0;,0;,0;,0;,0;,0;,0;,0;,0;,0;,0;,0;,0;,0;,0;,0;,0;,0;,0;,0;,0;,0;,0;,0;,0;,0;,0;,0;,0;,0;,
0;,0;,0;,0;,0;,0;,0;,0;,0;,0;,0;,0;,0;,0;,0;,0;,0;,0;,4;,4;,4;,4;,0;,0;,0;,0;,0;,0;,0;,0;,0;,0;,0;,0;,0;,0;,4;,4;,4;,4;,0;,0;,0;,0;,0;,
0;,0;,0;,0;,0;,0;,0;,0;,0;,0;,0;,0;,0;,0;,0;,0;,0;,0;,0;,0;,0;,0;,0;,0;,0;,0;,0;,0;,0;,0;,0;,0;,0;,0;,0;,0;,0;,0;,0;,0;,0;,0;,0;,0;,0;,
0;,0;,0;,0;,0;,0;,0;,0;,0;,0;,0;,0;,0;,0;,0;,0;,0;,0;,0;,0;,0;,0;,0;,0;,0;,0;,0;,0;,0;,0;,0;,0;,0;,0;,0;,0;,0;,0;,0;,0;,0;,0;,0;,0;,0;,
0;,0;,0;,0;,0;,0;,0;,0;,0;,0;,0;,0;,0;,0;,0;,0;,0;,0;,0;,0;,0;,0;,0;,0;,0;,0;,0;,0;,0;,0;,0;,0;,0;,0;,0;,0;,0;,0;,0;,0;,0;,0;,0;,0;,0;,
0;,0;,0;,0;,0;,0;,0;,0;,0;,0;,0;,0;,0;,0;,0;,0;,0;,0;,0;,0;,0;,0;,0;,0;,0;,0;,0;,0;,0;,0;,0;,0;,0;,0;,0;,0;,0;,0;,0;,0;,0;,0;,0;,0;,0;,
0;,0;,0;,0;,0;,0;,0;,0;,0;,0;,0;,0;,0;,0;,0;,0;,0;,0;,0;,0;,0;,0;,0;,0;,0;,0;,0;,0;,0;,0;,0;,0;,0;,0;,0;,0;,0;,0;,0;,0;,0;,0;,0;,0;,0;,
0;,0;,0;,0;,0;,0;,0;,0;,0;,0;,0;,0;,0;,0;,0;,0;,0;,0;,4;,4;,4;,4;,0;,0;,0;,1;,1;,1;,1;,1;,1;,3;,0;,0;,0;,0;,4;,4;,4;,4;,0;,0;,0;,0;,0;,
0;,0;,0;,0;,0;,0;,0;,0;,0;,0;,0;,0;,0;,0;,0;,0;,0;,0;,0;,0;,0;,0;,0;,0;,0;,0;,0;,0;,0;,0;,0;,0;,0;,0;,0;,0;,0;,0;,0;,0;,0;,0;,0;,0;,0;,
0;,0;,0;,0;,0;,0;,0;,0;,0;,0;,0;,0;,0;,0;,0;,0;,0;,0;,0;,0;,0;,0;,0;,0;,0;,0;,0;,0;,0;,0;,0;,0;,0;,0;,0;,0;,0;,0;,0;,0;,0;,0;,0;,0;,0;,
0;,0;,0;,0;,0;,0;,0;,0;,0;,0;,0;,0;,0;,0;,0;,0;,0;,0;,0;,0;,0;,0;,0;,0;,0;,0;,0;,0;,0;,0;,0;,0;,0;,0;,0;,0;,0;,0;,0;,0;,0;,0;,0;,0;,0;,
8;,0;,0;,0;,0;,0;,0;,0;,0;,0;,0;,0;,0;,0;,0;,0;,0;,0;,0;,0;,0;,0;,0;,0;,0;,0;,0;,0;,0;,0;,0;,0;,0;,0;,0;,0;,0;,0;,0;,0;,0;,0;,0;,0;,0;,
1;,0;,0;,0;,0;,0;,0;,0;,0;,0;,0;,0;,2;0,1;,1;,0;,0;,0;,0;,0;,0;,0;,0;,0;,0;,0;,0;,0;,0;,0;,0;,0;,0;,0;,0;,0;,0;,0;,0;,0;,0;,0;,0;,0;,0;,
1;,0;,0;,0;,0;,0;,0;,0;,0;,0;,0;,0;,1;,1;,1;,0;,0;,0;,4;,4;,4;,4;,0;,0;,0;,0;,0;,0;,0;,0;,0;,0;,0;,0;,0;,0;,4;,4;,4;,4;,0;,0;,0;,1;,1;,
1;,0;,0;,0;,0;,0;,0;,0;,0;,0;,2;0,1;,1;,1;,1;,0;,0;,0;,0;,0;,0;,0;,0;,0;,0;,0;,0;,0;,0;,0;,0;,0;,0;,0;,0;,0;,0;,0;,0;,0;,0;,0;,0;,1;,1;,
1;,0;,0;,0;,0;,0;,0;,0;,0;,0;,1;,1;,1;,1;,1;,0;,0;,0;,0;,0;,0;,0;,0;,0;,0;,0;,0;,0;,2;0,0;,0;,0;,0;,0;,0;,0;,0;,0;,0;,0;,0;,0;,0;,1;,1;,
1;,0;,0;,0;,1;,1;,1;,1;,1;,1;,1;,1;,1;,1;,1;,0;,0;,0;,0;,0;,0;,0;,0;,0;,0;,1;,1;,1;,1;,1;,1;,1;,1;,0;,0;,0;,0;,0;,0;,0;,0;,0;,0;,1;,1;,
1;,5;,5;,5;,1;,1;,1;,1;,1;,1;,1;,1;,1;,1;,1;,5;,5;,5;,5;,5;,5;,5;,5;,5;,5;,1;,1;,1;,1;,1;,1;,1;,1;,5;,5;,5;,5;,5;,5;,5;,5;,5;,5;,1;,1;,
