8,1,6,1
0;,0;,0;,0;,0;,0;,0;,0;,0;,0;,0;,0;,0;,0;,0;,0;,0;,0;,0;,0;,0;,0;,0;,0;,0;,0;,0;,0;,0;,0;,0;,0;,0;,0;,0;,0;,0;,0;,0;,0;,0;,0;,0;,0;,0;,
0;,0;,0;,0;,0;,0;,0;,0;,0;,0;,0;,0;,0;,0;,0;,0;,0;,0;,0;,0;,0;,0;,0;,0;,0;,0;,0;,0;,0;,0;,0;,0;,0;,0;,0;,0;,0;,0;,0;,0;,0;,0;,0;,0;,0;,
1;,1;,1;,1;,1;,1;,1;,1;,1;,1;,1;,1;,1;,1;,1;,1;,1;,1;,1;,1;,1;,1;,1;,1;,1;,1;,1;,1;,1;,1;,1;,1;,1;,1;,1;,1;,1;,1;,1;,1;,1;,1;,1;,1;,1;,
0;,0;,0;,0;,0;,0;,0;,0;,0;,0;,1;,1;,0;,0;,1;,1;,1;,1;,1;,1;,0;,0;,1;,1;,1;,1;,0;,0;,0;,0;,0;,0;,1;,1;,1;,1;,0;,0;,0;,0;,0;,0;,0;,0;,0;,
0;,0;,0;,0;,0;,0;,0;,0;,0;,0;,1;,1;,0;,0;,1;,1;,1;,1;,1;,1;,0;,0;,1;,1;,1;,1;,0;,0;,0;,0;,0;,0;,1;,1;,1;,1;,0;,0;,0;,0;,0;,0;,0;,0;,0;,
0;,0;,0;,0;,0;,0;,0;,0;,0;,0;,1;,1;,0;,0;,0;,0;,0;,0;,4;,4;,0;,0;,0;,1;,0;,0;,0;,0;,0;,0;,0;,0;,1;,1;,1;,1;,0;,0;,0;,0;,0;,0;,0;,0;,0;,
0;,0;,0;,0;,0;,0;,0;,0;,0;,0;,1;,1;,0;,0;,0;,0;,0;,0;,4;,4;,0;,0;,0;,1;,0;,0;,0;,0;,2;0,0;,0;,0;,1;,1;,1;,1;,0;,0;,0;,0;,0;,0;,0;,0;,0;,
0;,0;,0;,0;,0;,0;,0;,0;,0;,0;,1;,1;,0;,0;,0;,0;,0;,0;,4;,4;,0;,0;,0;,1;,0;,0;,0;,0;,1;,1;,0;,0;,1;,1;,1;,1;,0;,0;,0;,0;,0;,0;,0;,0;,0;,
0;,0;,0;,0;,0;,0;,0;,0;,0;,0;,0;,0;,0;,0;,0;,0;,0;,0;,1;,1;,0;,0;,0;,1;,0;,0;,0;,0;,1;,1;,0;,0;,1;,1;,1;,1;,0;,0;,0;,0;,0;,0;,0;,0;,0;,
0;,0;,0;,0;,0;,0;,0;,0;,0;,0;,0;,0;,0;,0;,0;,0;,0;,0;,1;,1;,0;,0;,0;,1;,0;,0;,0;,0;,1;,1;,0;,0;,1;,1;,1;,1;,0;,0;,0;,0;,0;,0;,0;,0;,0;,
0;,0;,0;,0;,0;,0;,0;,0;,0;,0;,0;,0;,0;,0;,0;,0;,0;,0;,1;,1;,0;,0;,0;,1;,0;,0;,0;,0;,1;,1;,0;,0;,0;,0;,0;,0;,0;,0;,0;,0;,0;,0;,0;,0;,0;,
0;,0;,0;,0;,0;,0;,0;,0;,0;,0;,0;,0;,0;,0;,0;,0;,0;,0;,1;,1;,0;,0;,0;,1;,0;,0;,0;,0;,1;,1;,0;,0;,0;,0;,0;,0;,0;,0;,0;,0;,0;,0;,0;,0;,0;,
0;,0;,0;,0;,0;,0;,0;,0;,1;,1;,0;,0;,0;,0;,0;,0;,0;,0;,1;,1;,0;,0;,0;,1;,0;,0;,0;,0;,1;,1;,0;,0;,0;,0;,0;,0;,0;,0;,0;,0;,0;,0;,0;,0;,0;,
0;,0;,0;,0;,0;,0;,0;,0;,1;,1;,0;,0;,0;,0;,0;,0;,0;,0;,1;,1;,0;,0;,0;,1;,0;,0;,0;,0;,1;,1;,0;,0;,0;,0;,0;,0;,0;,0;,0;,0;,0;,0;,0;,0;,6;,
0;,0;,0;,0;,0;,0;,0;,0;,1;,1;,0;,0;,0;,0;,0;,0;,0;,0;,1;,1;,0;,0;,0;,1;,0;,0;,0;,0;,1;,1;,0;,0;,0;,0;,0;,0;,0;,0;,0;,0;,0;,0;,0;,0;,0;,
0;,0;,0;,0;,0;,0;,0;,0;,1;,1;,0;,0;,0;,0;,0;,0;,0;,0;,1;,1;,0;,0;,0;,1;,0;,0;,0;,0;,1;,1;,0;,0;,0;,0;,0;,0;,0;,0;,0;,0;,0;,0;,0;,0;,1;,
0;,0;,0;,0;,0;,0;,0;,0;,1;,1;,0;,0;,0;,0;,0;,0;,0;,0;,1;,1;,0;,0;,0;,1;,0;,0;,0;,0;,1;,1;,0;,0;,0;,0;,0;,0;,0;,0;,0;,0;,0;,0;,0;,0;,1;,
0;,0;,1;,0;,0;,0;,0;,0;,1;,1;,0;,0;,0;,0;,0;,0;,0;,0;,1;,1;,0;,0;,0;,1;,0;,0;,0;,0;,1;,1;,0;,0;,0;,0;,0;,0;,0;,0;,0;,0;,0;,0;,0;,0;,1;,
0;,6;,1;,0;,0;,0;,0;,0;,1;,1;,0;,0;,0;,0;,6;,6;,6;,6;,1;,1;,0;,0;,0;,1;,6;,1;,0;,0;,1;,1;,0;,0;,0;,2;0,0;,2;0,0;,0;,0;,0;,0;,0;,0;,0;,0;,
1;,1;,1;,0;,0;,0;,0;,0;,1;,1;,1;,1;,0;,0;,1;,1;,1;,1;,1;,1;,0;,0;,0;,1;,1;,1;,0;,0;,1;,1;,0;,0;,1;,1;,1;,1;,0;,0;,0;,0;,0;,0;,0;,0;,0;,
0;,0;,0;,0;,0;,0;,0;,0;,0;,0;,1;,1;,0;,0;,0;,0;,0;,0;,0;,0;,0;,0;,0;,0;,0;,0;,0;,0;,0;,0;,0;,0;,0;,0;,0;,0;,0;,0;,0;,0;,0;,0;,0;,0;,0;,
0;,0;,0;,0;,0;,0;,0;,0;,0;,0;,1;,1;,0;,0;,0;,0;,0;,0;,0;,0;,0;,0;,0;,0;,0;,0;,0;,0;,0;,0;,0;,0;,0;,0;,0;,0;,0;,0;,0;,0;,0;,0;,0;,0;,0;,
8;,0;,0;,0;,0;,0;,0;,0;,0;,2;0,0;,0;,0;,0;,0;,0;,0;,2;0,0;,0;,2;0,0;,0;,0;,0;,0;,0;,0;,0;,0;,0;,0;,0;,0;,0;,0;,0;,0;,0;,0;,0;,0;,0;,0;,0;,
1;,1;,1;,1;,1;,1;,1;,1;,1;,1;,1;,1;,1;,1;,1;,1;,1;,1;,1;,1;,1;,1;,1;,1;,1;,1;,1;,1;,1;,1;,1;,1;,1;,1;,1;,1;,1;,1;,0;,0;,0;,0;,1;,1;,1;,
1;,1;,1;,1;,1;,1;,1;,1;,1;,1;,1;,1;,1;,1;,1;,1;,1;,1;,1;,1;,1;,1;,1;,1;,1;,1;,1;,1;,1;,1;,1;,1;,1;,1;,1;,1;,1;,1;,5;,5;,5;,5;,1;,1;,1;,
