4,5,4,3
1;,2;1,0;,0;,0;,0;,0;,0;,0;,0;,0;,0;,0;,0;,0;,0;,0;,0;,0;,0;,0;,0;,0;,0;,0;,0;,0;,0;,0;,0;,0;,0;,8;,0;,0;,0;,0;,0;,0;,0;,0;,0;,0;,2;3,1;,
1;,2;1,0;,0;,0;,0;,0;,0;,0;,0;,0;,0;,0;,0;,0;,0;,0;,0;,0;,0;,0;,0;,0;,0;,0;,0;,0;,0;,0;,0;,0;,0;,0;,0;,0;,0;,0;,0;,0;,0;,0;,0;,0;,2;3,1;,
1;,2;1,0;,0;,0;,0;,0;,0;,0;,0;,0;,0;,0;,0;,0;,0;,0;,0;,0;,0;,0;,0;,0;,0;,0;,0;,0;,0;,0;,0;,0;,0;,0;,0;,0;,0;,0;,0;,0;,0;,0;,0;,0;,2;3,1;,
1;,2;1,0;,0;,0;,0;,0;,0;,0;,0;,0;,0;,0;,0;,0;,0;,0;,0;,0;,0;,0;,0;,0;,0;,0;,0;,0;,0;,0;,0;,0;,0;,0;,0;,0;,0;,0;,0;,0;,0;,0;,0;,0;,2;3,1;,
1;,2;1,0;,0;,0;,0;,0;,0;,0;,0;,0;,0;,0;,0;,0;,0;,0;,0;,0;,0;,0;,0;,0;,0;,0;,0;,0;,0;,0;,0;,0;,0;,0;,0;,0;,0;,0;,0;,0;,0;,0;,0;,0;,2;3,1;,
1;,2;1,0;,0;,0;,0;,0;,0;,0;,0;,0;,0;,0;,0;,0;,0;,0;,0;,0;,0;,0;,0;,0;,0;,0;,0;,0;,0;,0;,0;,0;,0;,0;,0;,0;,0;,0;,0;,0;,0;,0;,0;,0;,2;3,1;,
1;,2;1,0;,0;,0;,0;,0;,0;,0;,0;,0;,0;,0;,0;,0;,0;,0;,0;,0;,0;,0;,0;,0;,0;,0;,0;,0;,0;,0;,0;,0;,0;,0;,0;,0;,0;,0;,0;,0;,0;,0;,0;,0;,2;3,1;,
1;,2;1,0;,0;,0;,0;,0;,0;,0;,0;,0;,0;,0;,0;,0;,0;,0;,0;,0;,0;,0;,0;,0;,0;,0;,0;,0;,0;,0;,0;,0;,0;,0;,0;,0;,0;,0;,0;,0;,0;,0;,0;,0;,2;3,1;,
1;,2;1,0;,0;,0;,0;,0;,0;,0;,0;,0;,0;,0;,0;,0;,0;,0;,0;,0;,0;,0;,0;,0;,0;,0;,0;,0;,0;,0;,0;,0;,0;,0;,0;,0;,0;,0;,0;,0;,0;,0;,0;,0;,2;3,1;,
1;,2;1,0;,0;,0;,0;,0;,0;,0;,0;,0;,0;,0;,0;,0;,0;,0;,0;,0;,0;,0;,0;,0;,0;,0;,0;,0;,0;,0;,0;,0;,0;,0;,0;,0;,0;,0;,0;,0;,0;,0;,0;,0;,2;3,1;,
1;,2;1,0;,0;,0;,0;,0;,0;,0;,0;,0;,0;,0;,0;,0;,0;,0;,0;,0;,0;,0;,0;,0;,0;,0;,0;,0;,0;,0;,0;,0;,0;,0;,0;,0;,0;,0;,0;,0;,0;,0;,0;,0;,2;3,1;,
1;,2;1,0;,0;,0;,0;,0;,0;,0;,0;,0;,0;,0;,0;,0;,0;,0;,0;,0;,0;,0;,0;,0;,0;,0;,0;,0;,0;,0;,0;,0;,0;,0;,0;,0;,0;,0;,0;,0;,0;,0;,0;,0;,2;3,1;,
1;,2;1,0;,0;,0;,0;,0;,0;,0;,0;,0;,0;,0;,0;,0;,0;,0;,0;,0;,0;,0;,0;,0;,0;,0;,0;,0;,0;,0;,0;,0;,0;,0;,0;,0;,0;,0;,0;,0;,0;,0;,0;,0;,2;3,1;,
1;,2;1,0;,0;,0;,0;,0;,0;,0;,0;,0;,0;,0;,0;,0;,0;,0;,0;,0;,0;,0;,0;,0;,0;,0;,0;,0;,0;,0;,0;,0;,0;,0;,0;,0;,0;,0;,0;,0;,0;,0;,0;,0;,2;3,1;,
1;,1;1,2;0,2;0,2;0,2;0,2;0,2;0,2;0,2;0,2;0,2;0,0;0,0;,0;,0;,0;,0;,0;,0;,0;,0;,0;,0;,0;,0;,0;,0;,0;,0;,0;,0;,0;,0;,0;,0;,0;,0;,0;,0;,0;,0;,0;,0;3,0;,
1;,1;1,1;,1;,1;,1;,1;,1;,1;,1;,1;,1;,2;1,0;,0;,0;,0;,0;,0;,0;,0;,0;,0;,0;,0;,0;,0;,0;,0;,0;,0;,0;,0;,0;,0;,0;,0;,0;,0;,0;,0;,0;,0;,0;3,0;,
0;,0;1,0;,0;,0;,0;,0;,0;,0;,0;,0;,1;,2;1,0;,0;,0;,0;,0;,0;,0;,0;,0;,0;,0;,0;,0;,0;,0;,0;,0;,0;,0;,0;,0;,0;,0;,0;,0;,0;,0;,0;,0;,0;,0;3,0;,
0;,0;1,0;,0;,0;,0;,0;,0;,0;,0;,0;,1;,2;1,0;,0;,0;,0;,0;,0;,0;,0;,0;,0;,0;,0;,0;,0;,0;,0;,0;,0;,0;,0;,0;,0;,0;,0;,0;,0;,0;,0;,0;,0;,0;3,0;,
0;,0;1,0;0,0;0,0;0,0;0,0;0,0;0,0;0,0;0,0;0,1;0,2;1,0;,0;,0;,0;,0;,0;,0;,0;,0;,0;,0;,0;,0;,0;,0;,0;,0;,0;,0;,0;,0;,0;,0;,0;,0;,0;,0;,0;,0;,0;,0;3,0;,
0;,0;1,0;,0;,0;,0;,0;,0;,0;,0;,0;,1;,2;1,0;,0;,0;,0;,0;,0;,0;,0;,0;,0;,0;,0;,0;,0;,0;,0;,0;,0;,0;,0;,0;,0;,0;,0;,0;,0;,0;,0;,0;,0;,0;3,0;,
0;,0;1,0;,0;,0;,0;,0;,0;,0;,0;,0;,1;,2;1,0;,0;,0;,0;,0;,0;,0;,0;,0;,0;,0;,0;,0;,0;,0;,0;,0;,0;,0;,0;,0;,0;,0;,0;,0;,0;,0;,0;,0;,0;,0;3,0;,
0;,0;1,0;,0;,0;,0;,0;,0;,0;,0;,0;,1;,2;1,0;,0;,0;,0;,0;,0;,0;,0;,0;,0;,0;,0;,0;,0;,0;,0;,0;,0;,0;,0;,0;,0;,0;,0;,0;,0;,0;,0;,0;,0;,0;3,0;,
0;,0;1,0;,0;,0;,0;,0;,0;,0;,0;,0;,1;,2;1,0;,0;,0;,0;,0;,0;,0;,0;,0;,0;,0;,0;,0;,0;,0;,0;,0;,0;,0;,0;,0;,0;,0;,0;,0;,0;,0;,0;,0;,0;,0;3,0;,
0;,0;1,0;,0;,0;,0;,0;,0;,0;,0;,0;,1;,2;1,0;,0;,0;,0;,0;,0;,0;,0;,0;,0;,0;,0;,0;,0;,0;,0;,0;,0;,0;,0;,0;,0;,0;,0;,0;,0;,0;,0;,0;,0;,0;3,0;,
1;,1;1,1;,1;,1;,1;,1;,1;,1;,0;,0;,1;,2;1,2;0,2;0,2;0,2;0,2;0,2;0,2;0,2;0,2;0,2;0,2;0,2;0,2;0,2;0,2;0,2;0,2;0,2;0,2;0,2;0,2;0,2;0,2;0,2;0,2;0,2;0,2;0,2;0,2;0,2;0,2;0,2;0,
