5,5,5,4
1;,0;1,0;,0;,0;,0;,0;,0;,0;,0;,8;,0;,0;,0;,0;,0;,0;,0;,0;,0;,0;,0;,0;,0;,0;,0;,0;,0;,0;,0;,0;,0;,0;,0;,0;,0;,0;,0;,0;,0;,0;,0;,0;,0;3,1;,
1;,0;1,0;,0;,0;,0;,0;,0;,0;,0;,0;,0;,0;,0;,0;,0;,0;,0;,0;,0;,0;,0;,0;,0;,0;,0;,0;,0;,0;,0;,0;,0;,0;,0;,0;,0;,0;,0;,0;,0;,0;,0;,0;,0;3,1;,
1;,0;1,0;,0;,0;,0;,0;,0;,0;,0;,6;,0;,0;,0;,0;,0;,0;,0;,0;,0;,0;,0;,0;,0;,0;,0;,0;,0;,0;,0;,0;,0;,0;,0;,0;,0;,0;,0;,0;,0;,0;,0;,0;,0;3,1;,
1;,0;1,0;,0;,0;,0;,0;,0;,0;,0;,6;,0;,0;,0;,0;,0;,0;,0;,0;,0;,0;,0;,0;,0;,0;,0;,0;,0;,0;,0;,0;,0;,0;,0;,0;,0;,0;,0;,0;,0;,0;,0;,0;,0;3,1;,
1;,0;1,0;,0;,0;,0;,0;,0;,0;,0;,6;,0;,0;,0;,0;,0;,0;,0;,0;,0;,0;,0;,0;,0;,0;,0;,0;,0;,0;,0;,0;,0;,0;,0;,0;,0;,0;,0;,0;,0;,0;,0;,0;,0;3,1;,
1;,0;1,0;,0;,0;,0;,0;,0;,0;,0;,6;,0;,0;,0;,0;,0;,0;,0;,0;,0;,0;,0;,0;,0;,0;,0;,0;,0;,0;,0;,0;,0;,0;,0;,0;,0;,0;,0;,0;,0;,0;,0;,0;,0;3,1;,
1;,0;1,0;,0;,0;,0;,0;,0;,0;,0;,6;,0;,0;,0;,0;,0;,0;,0;,0;,0;,0;,0;,0;,0;,0;,0;,0;,0;,0;,0;,0;,0;,0;,0;,0;,0;,0;,0;,0;,0;,0;,0;,0;,0;3,1;,
1;,0;1,0;,0;,0;,0;,0;,0;,0;,0;,6;,0;,0;,0;,0;,0;,0;,0;,0;,0;,0;,0;,0;,0;,0;,0;,0;,0;,0;,0;,0;,0;,0;,0;,0;,0;,0;,0;,0;,0;,0;,0;,0;,0;3,1;,
1;,0;1,0;,0;,0;,0;,0;,0;,0;,0;,6;,0;,0;,0;,0;,0;,0;,0;,0;,0;,0;,0;,0;,0;,0;,0;,0;,0;,0;,0;,0;,0;,0;,0;,0;,0;,0;,0;,0;,0;,0;,0;,0;,0;3,1;,
1;,0;1,0;,0;,0;,0;,0;,0;,0;,0;,6;,0;,0;,0;,0;,0;,0;,0;,0;,0;,0;,0;,0;,0;,0;,0;,0;,0;,0;,0;,0;,0;,0;,0;,0;,0;,0;,0;,0;,0;,0;,0;,0;,0;3,1;,
1;,0;1,0;,0;,0;,0;,0;,0;,0;,0;,6;,0;,0;,0;,0;,0;,0;,0;,0;,0;,0;,0;,0;,0;,0;,0;,0;,0;,0;,0;,0;,0;,0;,0;,0;,0;,0;,0;,0;,0;,0;,0;,0;,0;3,1;,
1;,0;1,0;,0;,0;,0;,0;,0;,0;,0;,6;,0;,0;,0;,0;,0;,0;,0;,0;,0;,0;,0;,0;,0;,0;,0;,0;,0;,0;,0;,0;,0;,0;,0;,0;,0;,0;,0;,0;,0;,0;,0;,0;,7;3,1;,
1;,0;1,0;,0;,0;,0;,0;,0;,0;,0;,6;,0;,0;,0;,0;,0;,0;,0;,0;,0;,0;,0;,0;,1;,1;,1;,1;,4;,4;,4;,4;,4;,4;,4;,4;,4;,4;,4;,4;,4;,4;,1;,1;,1;3,1;,
1;,0;1,0;,0;,0;,0;,0;,0;,0;,0;,6;,0;,0;,0;,0;,0;,0;,0;,0;,0;,0;,0;,0;,1;,1;,1;,1;,0;,0;,0;,0;,0;,0;,0;,0;,0;,0;,0;,0;,0;,0;,1;,1;,1;3,1;,
1;,0;1,0;0,0;0,0;0,0;0,0;0,0;0,0;0,0;0,6;0,0;0,0;0,0;,0;,0;,0;,0;,0;,0;,0;,0;,0;,1;,1;,1;,1;,0;,0;,0;,0;,0;,0;,0;,0;,0;,0;,0;,0;,0;,0;,0;,0;,0;3,1;,
1;,0;1,0;,0;,0;,0;,0;,0;,0;,0;,6;,0;,0;1,0;,0;,0;,0;,0;,0;,0;,0;,0;,0;,1;,1;,1;,1;,0;,0;,0;,0;,0;,0;,0;,0;,0;,0;,0;,0;,0;,0;,0;,0;,0;3,1;,
1;,0;1,0;,0;,0;,0;,0;,0;,0;,0;,6;,0;,0;1,0;,0;,0;,0;,0;,0;,1;,1;,1;,1;,1;,1;,1;,1;,0;,0;,0;,0;,0;,0;,0;,0;,0;,0;,0;,0;,0;,0;,0;,0;,0;3,1;,
1;,0;1,0;,0;,0;,0;,0;,0;,0;,0;,6;,0;,0;1,0;,0;,0;,0;,0;,0;,1;,1;,1;,1;,1;,1;,1;,1;,0;,0;,0;,0;,0;,0;,0;,0;,0;,0;,0;,0;,0;,0;,0;,0;,0;3,1;,
1;,0;1,0;0,0;0,0;0,0;0,0;0,0;0,0;0,0;0,6;0,0;0,0;1,0;,0;,0;,0;,0;,0;,1;,1;,1;,1;,1;,1;,1;,1;,0;,0;,0;,0;,0;,0;,0;,0;,0;,0;,0;,0;,0;,0;,0;,0;,0;3,1;,
1;,0;1,0;,0;,0;,0;,0;,0;,0;,0;,6;,0;,0;1,0;,0;,0;,0;,0;,0;,1;,1;,1;,1;,1;,1;,1;,1;,0;,0;,0;,0;,0;,0;,0;,0;,0;,0;,0;,0;,0;,0;,0;,0;,0;3,1;,
1;,0;1,0;,0;,0;,0;,0;,0;,0;,0;,6;,0;,0;1,0;,0;,1;,1;,1;,1;,1;,1;,1;,1;,1;,1;,1;,1;,0;,0;,0;,0;,0;,0;,0;,0;,0;,0;,0;,0;,0;,0;,0;,0;,0;3,1;,
1;,0;1,0;,0;,0;,0;,0;,0;,0;,0;,6;,0;,0;1,0;,0;,1;,1;,1;,1;,1;,1;,1;,1;,1;,1;,1;,1;,0;,0;,0;,0;,0;,0;,0;,0;,0;,0;,0;,0;,0;,0;,0;,0;,0;3,1;,
1;,0;1,0;,0;,0;,0;,0;,0;,0;,0;,6;,0;,0;1,0;,0;,1;,1;,1;,1;,1;,1;,1;,1;,1;,1;,1;,1;,0;,0;,0;,0;,0;,0;,0;,0;,0;,0;,0;,0;,0;,0;,0;,0;,0;3,1;,
1;,0;1,0;,0;,0;,0;,0;,0;,0;,0;,0;,0;,0;1,0;,0;,1;,1;,1;,1;,1;,1;,1;,1;,1;,1;,1;,1;,2;0,2;0,2;0,2;0,2;0,2;0,2;0,2;0,2;0,2;0,2;0,2;0,2;0,2;0,2;0,2;0,2;0,1;,
1;,1;1,1;,1;,1;,1;,1;,1;,1;,1;,1;,1;,1;1,1;0,1;0,1;0,1;0,1;0,1;0,1;0,1;0,1;0,1;0,1;0,1;0,1;0,1;0,1;0,1;0,1;0,1;0,1;0,1;0,1;0,1;0,1;0,1;0,1;0,1;0,1;0,1;0,1;0,1;0,1;0,1;0,
