3,1,1,1
1;,1;,1;,1;,1;,1;,1;,1;,1;,1;,1;,1;,1;,1;,1;,1;,1;,1;,1;,1;,5;,5;,5;,5;,5;,1;,1;,5;,5;,5;,1;,5;,5;,1;,5;,5;,1;,5;,5;,5;,1;,5;,5;,1;,1;,
0;,0;,0;,0;,0;,1;,1;,1;,0;,0;,0;,0;,0;,0;,0;,0;,0;,0;,0;,0;,0;,5;,5;,0;,5;,5;,1;,5;,5;,5;,5;,1;,5;,5;,5;,5;,5;,5;,5;,5;,1;,5;,0;,0;,1;,
0;,0;,0;,0;,0;,1;,1;,1;,0;,0;,0;,0;,0;,0;,0;,0;,0;,0;,0;,0;,0;,5;,0;,0;,0;,5;,5;,5;,5;,5;,5;,1;,5;,5;,1;,5;,5;,5;,5;,5;,5;,5;,0;,0;,1;,
0;,8;,0;,0;,0;,1;,1;,1;,0;,0;,0;,0;,0;,0;,0;,0;,0;,0;,0;,0;,0;,0;,0;,0;,0;,0;,5;,5;,5;,0;,5;,1;,5;,5;,0;,0;,5;,5;,1;,5;,0;,0;,0;,0;,1;,
1;,1;,1;,0;,0;,1;,1;,1;,0;,0;,0;,0;,0;,0;,0;,0;,0;,0;,0;,0;,0;,0;,0;,0;,0;,0;,5;,5;,0;,0;,5;,1;,5;,0;,0;,0;,5;,1;,5;,0;,0;,0;,0;,0;,1;,
1;,1;,0;,0;,0;,1;,1;,1;,0;,0;,0;,0;,0;,0;,0;,0;,0;,0;,0;,0;,0;,0;,0;,6;,0;,0;,0;,5;,0;,0;,5;,5;,5;,0;,0;,0;,5;,1;,0;,0;,0;,0;,0;,0;,1;,
1;,1;,0;,0;,6;,1;,1;,1;,0;,0;,0;,0;,0;,0;,0;,0;,0;,0;,0;,0;,0;,0;,0;,0;,0;,0;,0;,5;,0;,0;,1;,5;,0;,0;,0;,0;,0;,5;,0;,0;,0;,0;,0;,0;,1;,
1;,2;1,0;,0;,0;,1;,1;,1;,0;,0;,0;,0;,0;,0;,0;,0;,0;,0;,0;,0;,0;,0;,0;,0;,0;,0;,0;,5;,0;,0;,1;,5;,0;,0;,0;,0;,5;,5;,0;,0;,0;,5;,0;,0;,1;,
1;,2;1,0;,0;,0;,1;,1;,1;,0;,0;,0;,0;,0;,0;,0;,0;,0;,0;,0;,0;,0;,0;,5;,0;,0;,0;,0;,0;,0;,0;,5;,0;,0;,0;,0;,0;,5;,5;,0;,0;,5;,0;,0;,0;,1;,
1;,2;1,0;,0;,6;,1;,1;,1;,0;,0;,0;,0;,0;,0;,0;,0;,0;,0;,0;,0;,0;,0;,5;,0;,0;,0;,0;,0;,0;,0;,5;,0;,0;,0;,0;,0;,5;,5;,0;,0;,5;,0;,0;,0;,1;,
1;,2;1,0;,0;,0;,1;,1;,1;,0;,0;,0;,0;,0;,0;,0;,0;,0;,0;,0;,0;,0;,0;,5;,5;,0;,6;,0;,0;,0;,0;,0;,0;,0;,5;,0;,0;,5;,0;,0;,0;,0;,0;,0;,0;,1;,
1;,1;,0;,0;,0;,1;,1;,1;,0;,0;,0;,0;,0;,0;,0;,0;,0;,0;,0;,0;,0;,0;,5;,1;,0;,0;,0;,0;,0;,0;,0;,0;,0;,5;,0;,5;,0;,0;,0;,0;,0;,0;,0;,0;,1;,
1;,1;,0;,0;,6;,1;,1;,1;,0;,0;,0;,0;,0;,0;,0;,0;,0;,0;,0;,0;,0;,0;,5;,1;,0;,0;,0;,0;,6;,0;,0;,0;,5;,5;,0;,5;,0;,0;,0;,0;,0;,5;,0;,0;,1;,
1;,1;,0;,0;,0;,2;3,1;,2;1,0;,0;,0;,0;,6;,0;,0;,0;,0;,0;,0;,0;,0;,0;,5;,1;,0;,0;,0;,0;,0;,0;,0;,0;,5;,0;,0;,0;,0;,0;,0;,0;,0;,5;,0;,0;,1;,
1;,1;,0;,0;,0;,2;3,1;,2;1,0;,0;,0;,0;,0;,0;,0;,0;,0;,0;,0;,0;,0;,5;,5;,1;,0;,0;,0;,0;,0;,0;,0;,0;,5;,0;,0;,0;,0;,0;,0;,0;,0;,5;,0;,0;,1;,
1;,1;,6;,0;,0;,1;,1;,1;,0;,0;,0;,0;,0;,0;,0;,0;,0;,6;,0;,0;,0;,5;,5;,1;,6;,0;,0;,5;,0;,0;,0;,0;,0;,0;,0;,0;,0;,0;,0;,0;,0;,5;,0;,0;,1;,
1;,1;,0;,0;,0;,0;,0;,0;,0;,0;,0;,0;,0;,0;,0;,0;,1;,3;,1;,0;,0;,5;,1;,1;,0;,0;,0;,5;,5;,0;,0;,0;,0;,6;,0;,0;,0;,0;,0;,0;,0;,5;,0;,0;,1;,
1;,1;,0;,0;,0;,0;,0;,0;,0;,0;,0;,0;,0;,0;,0;,0;,1;,1;,1;,0;,5;,5;,1;,0;,0;,0;,0;,5;,1;,0;,0;,0;,0;,0;,0;,0;,0;,0;,0;,0;,5;,5;,0;,0;,1;,
1;,1;,6;,0;,0;,0;,0;,0;,0;,0;,0;,0;,0;,0;,0;,0;,1;,1;,1;,0;,5;,5;,1;,0;,0;,0;,0;,5;,1;,0;,0;,0;,0;,0;,0;,0;,0;,0;,0;,0;,5;,5;,0;,0;,1;,
1;,1;,0;,0;,0;,0;,0;,0;,0;,0;,0;,0;,0;,0;,0;,0;,1;,1;,1;,0;,0;,5;,0;,0;,0;,0;,5;,5;,1;,6;,0;,0;,0;,0;,0;,0;,0;,0;,0;,0;,0;,5;,0;,0;,1;,
1;,1;,0;,0;,0;,0;,0;,0;,0;,0;,0;,0;,0;,0;,0;,0;,1;,1;,1;,0;,0;,5;,0;,0;,0;,0;,5;,5;,1;,0;,0;,0;,0;,0;,0;,0;,0;,0;,0;,0;,0;,0;,0;,0;,1;,
1;,1;,6;,0;,0;,0;,0;,0;,0;,0;,0;,0;,0;,0;,0;,0;,1;,1;,1;,0;,0;,5;,0;,0;,0;,0;,5;,5;,1;,0;,0;,0;,0;,0;,0;,0;,0;,7;,0;,0;,0;,0;,0;,0;,1;,
1;,1;,0;,0;,0;,0;,0;,0;,6;,0;,0;,0;,0;,0;,0;,0;,1;,1;,1;,0;,0;,0;,0;,0;,0;,5;,5;,5;,5;,5;,0;,0;,0;,0;,0;,2;0,1;,1;,1;,2;0,0;,0;,0;,0;,1;,
1;,1;,5;,5;,5;,5;,5;,3;,3;,3;,5;,5;,5;,5;,5;,5;,1;,1;,1;,5;,5;,5;,5;,5;,5;,5;,1;,5;,5;,5;,5;,5;,5;,5;,5;,1;,1;,1;,1;,1;,5;,5;,5;,5;,1;,
1;,1;,1;,1;,1;,1;,1;,1;,1;,1;,1;,1;,1;,1;,1;,1;,1;,1;,1;,1;,1;,1;,1;,1;,1;,1;,1;,1;,1;,1;,1;,1;,1;,1;,1;,1;,1;,1;,1;,1;,1;,1;,1;,1;,1;,
