3,1,1,1
1;,1;,1;,1;,1;,1;,1;,1;,1;,1;,1;,1;,1;,1;,1;,1;,1;,1;,1;,1;,1;,1;,1;,1;,1;,1;,1;,1;,1;,1;,1;,1;,1;,1;,1;,1;,1;,1;,1;,1;,1;,1;,1;,1;,1;,
1;,0;,0;,0;,0;,0;,0;,0;,0;,0;,1;,0;,0;,0;,0;,0;,0;,0;,0;,0;,0;,0;,0;,0;,0;,0;,0;,0;,0;,0;,0;,0;,0;,0;,0;,0;,0;,0;,0;,0;,0;,0;,0;,0;,1;,
1;,0;,0;,0;,0;,0;,0;,0;,0;,0;,1;,0;,0;,0;,0;,0;,0;,0;,0;,0;,0;,0;,0;,0;,0;,0;,0;,0;,0;,0;,0;,0;,0;,0;,0;,0;,0;,0;,0;,0;,0;,0;,0;,0;,1;,
1;,0;,0;,0;,0;,0;,0;,0;,0;,0;,1;,0;,0;,1;,1;,1;,1;,1;,1;,1;,1;,1;,1;,1;,1;,1;,1;,1;,1;,1;,1;,1;,1;,1;,1;,1;,1;,1;,1;,1;,1;,1;,0;,0;,1;,
5;,0;,0;,0;,1;,1;,1;,6;0,6;0,2;3,1;0,0;0,0;0,1;0,0;0,0;0,0;0,0;0,0;0,0;0,0;0,0;0,0;0,0;0,0;0,0;0,0;0,0;0,0;0,0;0,0;0,0;0,0;0,0;0,0;0,0;0,0;0,0;0,0;0,0;0,0;,0;,0;,0;,1;,
5;,0;,0;,0;,1;,1;,2;1,6;2,6;2,2;3,1;2,0;2,0;2,1;2,0;2,0;2,0;2,0;,0;,0;,0;,0;,0;,0;,0;,0;,0;,0;,0;,0;,0;,0;,0;,0;,0;,0;,0;,0;,0;,0;,0;,0;,0;,0;,1;,
5;,0;,0;,0;,1;,1;,2;1,6;,6;,2;3,1;,0;,3;,1;,0;,0;,1;,4;,4;,4;,4;,4;,4;,4;,4;,4;,4;,4;,4;,4;,4;,4;,4;,4;,4;,4;,4;,4;,4;,4;,4;,4;,1;,1;,1;,
1;,0;,0;,0;,5;,1;,2;1,6;,6;,2;3,1;,0;,0;,1;,0;,0;,1;,2;0,2;0,2;0,2;0,2;0,2;0,2;0,2;0,2;0,2;0,2;0,2;0,2;0,2;0,2;0,2;0,2;0,2;0,2;0,2;0,2;0,2;0,2;0,2;0,2;0,1;,1;,1;,
1;,0;,0;,0;,5;,1;,2;1,6;,6;,2;3,1;,0;,0;,1;,0;,0;,1;,1;,1;,1;,1;,1;,1;,1;,1;,1;,1;,1;,1;,1;,1;,1;,1;,1;0,1;0,1;0,1;,1;,1;,1;,1;,1;,1;,1;,1;,
1;,0;,0;,0;,5;,1;,2;1,6;,6;,2;3,1;,0;,0;,1;,0;,0;,0;,0;,0;,0;,0;,0;,0;,0;,0;,0;,0;,0;,0;,0;,0;,0;,0;,0;,0;,0;,0;,0;,0;,0;,0;,0;,0;,0;,1;,
5;,0;,0;,0;,1;,1;,2;1,6;,6;,2;3,1;,0;,0;,1;,0;,0;,0;,6;,0;,0;,0;,0;,6;,0;,0;,0;,0;,6;,0;,0;,0;,0;,6;,0;,0;,0;,0;,6;,0;,0;,0;,0;,0;,0;,1;,
5;,0;,0;,0;,1;,1;,2;1,6;,6;,2;3,1;,0;,0;,1;,1;,1;,1;,1;,1;,1;,1;,1;,1;,1;,1;,1;,1;,1;,1;,1;,1;,1;,1;,1;,1;,1;,1;,1;,1;,1;,1;,1;,0;,0;,1;,
5;,0;,0;,0;,1;,1;,2;1,6;,6;,2;3,1;,0;,0;,1;,0;,0;,0;,0;,0;,0;,0;,0;,0;,0;,0;,0;,0;,0;,0;,0;,0;,0;,0;,0;,0;,0;,0;,0;,0;,0;,0;,0;,0;,0;,1;,
1;,0;,0;,0;,5;,1;,2;1,6;,6;,2;3,1;,0;,0;,1;,0;,0;,0;,0;,0;,0;,0;,0;,0;,0;,0;,0;,0;,0;,0;,0;,0;,0;,0;,0;,0;,0;,0;,0;,0;,0;,0;,0;,0;,0;,1;,
1;,0;,0;,0;,5;,1;,2;1,6;,6;,2;3,1;,3;,0;,1;,0;,0;,0;,0;,0;,0;,0;,0;,0;,0;,0;,0;,0;,0;,0;,0;,0;,0;,0;,0;,0;,0;,0;,0;,0;,0;,0;,0;,0;,0;,1;,
1;,0;,0;,0;,5;,1;,2;1,6;,6;,2;3,1;,0;,0;,1;,0;,0;,0;,0;,0;,0;,0;,0;,0;,0;,0;,0;,0;,0;,0;,0;,0;,0;,0;,0;,0;,0;,0;,0;,0;,0;,0;,0;,0;,0;,1;,
5;,0;,0;,0;,1;,1;,2;1,6;,6;,2;3,1;,0;,0;,1;,0;,0;,0;,0;,0;,6;,6;,0;,0;,0;,6;,6;,0;,0;,0;,6;,6;,0;,0;,0;,6;,6;,0;,0;,0;,0;,0;,0;,0;,0;,1;,
5;,0;,0;,0;,1;,1;,2;1,6;,6;,2;3,1;,0;,0;,1;,0;,0;,0;,0;,6;,0;,0;,6;,0;,6;,0;,0;,6;,0;,6;,0;,0;,6;,0;,6;,0;,0;,6;,0;,0;,0;,0;,0;,0;,0;,1;,
5;,0;,0;,0;,1;,1;,2;1,6;,6;,2;3,1;,0;,0;,1;,0;,0;,0;,4;,0;,0;,0;,0;,4;,0;,0;,0;,0;,4;,0;,0;,0;,0;,4;,0;,0;,0;,0;,4;,0;,0;,0;,0;,1;,1;,1;,
1;,0;,0;,0;,5;,1;,2;1,6;,6;,2;3,1;,0;,0;,1;,0;,0;,0;,0;,0;,0;,0;,0;,0;,0;,0;,0;,0;,0;,0;,0;,0;,0;,0;,0;,0;,0;,0;,0;,0;,0;,0;,0;,1;,1;,1;,
1;,0;,0;,0;,5;,1;,2;1,6;0,6;0,2;3,1;0,0;0,0;0,1;0,0;0,1;0,5;0,5;0,5;0,5;0,5;0,5;0,5;0,5;0,5;0,5;0,5;0,5;0,5;0,5;0,5;0,5;0,5;0,5;0,5;0,5;0,5;0,5;0,5;0,5;0,5;,5;,1;,1;,1;,
1;,0;,0;,0;,5;,1;,2;1,0;,0;,1;,1;,0;,0;,1;,0;,1;,1;,1;,1;,1;,1;,1;,1;,1;,1;,1;,1;,1;,1;,1;,1;,1;,1;,1;,1;,1;,1;,1;,1;,1;,1;,1;,1;,1;,1;,
0;,0;,0;,0;,1;,1;,2;1,0;,0;,0;,0;,0;,0;,1;,0;,0;,0;,0;,0;,0;,0;,0;,0;,0;,0;,0;,0;,0;,0;,0;,0;,0;,0;,0;,0;,0;,0;,0;,0;,0;,0;,0;,0;,0;,1;,
8;,0;,0;,0;,1;,1;,2;1,0;,0;,0;,0;,0;,0;,1;,0;,0;,0;,0;,0;,0;,0;,0;,0;,0;,0;,0;,0;,0;,0;,0;,0;,0;,0;,0;,0;,0;,0;,0;,0;,0;,0;,0;,0;,7;,1;,
1;,1;,1;,1;,1;,1;,1;,1;,1;,1;,1;,1;,3;,1;,1;,1;,1;,1;,1;,1;,1;,1;,1;,1;,1;,1;,1;,1;,1;,1;,1;,1;,1;,1;,1;,1;,1;,1;,1;,1;,1;,1;,1;,1;,1;,
